
account	tài khoản
app	chương trình
apple	quả táo
boy	cậu bé
cat	con mèo
duck	con vịt
earth	trái đất
family	gia đình
garden	vườn
hello	xin chào
i	tôi, ta, tớ
jean	quần bò
key	chìa khóa
large	rộng lớn
love	tình yêu
mouse	con chuột
nervous	lo lắng, bồn chồn
odd	lẻ, cọc cạch
on	bên trong
online	trực tuyến
peaceful	hòa bình
queue	hàng đợi
rich	giàu
supermarket	siêu thị
tooth	răng
user	người dùng
vocabulary	từ vựng
world	thế giới
x-ray	tia X
yellow	màu vàng
zebra	ngựa vằn
zoo	sở thú
